#################
#...........#...#
#.#.###.###.#.#.#
#...#...#.......#
###.#.#.#.#.#.#.#
#.........#.....#
#.###.###.#.#.###
#.........#.....#
#.#.###.#.#.#.#.#
#.#.........#...#
#.#.#.#.###.#.#.#
#.#.......#.....#
#.#.#.#.#.#.###.#
#.....#.......#*#
#.#.#.###.###.###
#...#..........o#
#################