##############
#.#..........#
#.#.######.#.#
#.#....#...#.#
#.###.*#.#.#.#
#...####.#.#.#
#.#.#..#.#.#.#
#.#.#.##.#.#.#
#o#......#.#.#
##############